a	a
jeho	jeho
k	k
so	so
wón	wón
zo	zo
na	na
pak	pak
je	je
to	to
dźeše	dźeše
z	z
woni	woni
do	do
tón	tón
nim	nim
jako	jako
wot	wot
teho	teho
běše	běše
ja	ja
w	w
wy	wy
njemu	njemu
by	by
jezus	jezus
jich	jich
ty	ty
tych	tych
budźe	budźe
tež	tež
ale	ale
za	za
wjele	wjele
jemu	jemu
dźachu	dźachu
dla	dla
kiž	kiž
tak	tak
běchu	běchu
jim	jim
bychu	bychu
sebi	sebi
hdyž	hdyž
zaso	zaso
tam	tam
su	su
njeho	njeho
wam	wam
won	won
ći	ći
hnydom	hnydom
te	te
abo	abo
ta	ta
dźěše	dźěše
budźa	budźa
tym	tym
hač	hač
po	po
njeje	njeje
kak	kak
štož	štož
wo	wo
wona	wona
ze	ze
kotryž	kotryž
horje	horje
mje	mje
nich	nich
być	być
tebi	tebi
pola	pola
my	my
wšitko	wšitko
same	same
prjedy	prjedy
praju	praju
ničo	ničo
lud	lud
jedyn	jedyn
was	was
swoje	swoje
sobu	sobu
poča	poča
ju	ju
hdźež	hdźež
sym	sym
hlaj	hlaj
wone	wone
temu	temu
teje	teje
swojeho	swojeho
słowo	słowo
dele	dele
bože	bože
wšak	wšak
widźeše	widźeše
ma	ma
kotrež	kotrež
jo	jo
jara	jara
hišće	hišće
bóh	bóh
zawoła	zawoła
wza	wza
wučomnikow	wučomnikow
wjazy	wjazy
we	we
swojim	swojim
swojich	swojich
pětr	pětr
da	da
bu	bu
tu	tu
tej	tej
sy	sy
swojej	swojej
štó	štó
sam	sam
nichtó	nichtó
dyžli	dyžli
bych	bych
wopraša	wopraša
preč	preč
prajić	prajić
nětk	nětk
morju	morju
mnu	mnu
měješe	měješe
jene	jene
jana	jana
hdy	hdy
dźěchu	dźěchu
wokoło	wokoło
